10
8
1
1
1,1,1,1,1,1,1,1,1,1
1,2,2,2,2,2,2,2,2,1
1,2,50,2,51,2,2,2,2,1
1,2,2,2,2,2,2,50,2,1
1,2,2,51,2,2,2,2,2,1
1,2,2,2,2,50,51,2,2,1
1,2,2,2,2,2,2,2,14,1
1,1,1,1,1,1,1,1,1,1