12
10
1
1
1,1,1,1,1,1,1,1,1,1,1,1
1,2,2,2,2,2,2,2,2,2,2,1
1,2,3,20,3,3,21,3,3,22,2,1
1,2,3,3,3,3,3,3,3,3,2,1
1,2,2,12,2,2,2,2,12,2,2,1
1,2,31,31,10,31,31,11,31,2,1
1,2,31,31,31,31,31,31,31,2,1
1,2,2,2,2,13,2,2,2,14,2,1
1,2,4,4,4,4,4,4,4,4,2,1
1,1,1,1,1,1,1,1,1,1,1,1