18
16
3
3
249,249,249,249,249,249,249,249,249,249,249,249,249,249,249,249,249,249
249,249,249,249,249,249,249,249,249,249,249,249,249,249,249,249,249,249
249,249,249,249,249,249,249,249,249,249,249,249,249,249,249,249,249,249
249,249,249,249,249,249,249,249,249,249,249,249,249,249,249,249,249,249
249,249,249,249,249,249,249,249,249,249,249,249,249,249,249,249,249,249
249,249,249,249,249,249,249,249,249,249,249,249,249,249,249,249,249,249
249,249,249,249,249,249,249,249,249,249,249,249,249,249,249,249,249,249
249,249,249,249,249,249,249,249,249,249,249,249,249,249,249,249,249,249
249,249,249,249,249,249,249,249,249,249,249,249,249,249,249,249,249,249
249,249,249,249,249,249,249,249,249,249,249,249,249,249,249,249,249,249
249,249,249,249,249,249,249,249,249,249,249,249,249,249,249,249,249,249
249,249,249,249,249,249,249,249,249,249,249,249,249,249,249,249,249,249
249,249,249,249,249,249,249,249,249,249,249,249,249,249,249,249,249,249
249,249,249,249,249,249,249,249,249,249,249,249,249,249,249,249,249,249
249,249,249,249,249,249,249,249,249,249,249,249,249,249,249,249,249,249
249,249,249,249,249,249,249,249,249,249,249,249,249,249,249,249,249,249
235,265,265,265,265,265,265,265,265,265,265,265,265,265,265,265,265,236
250,235,265,265,265,265,265,265,265,265,265,265,265,265,265,265,236,248
250,250,0,0,0,0,0,0,0,0,0,0,0,0,0,0,248,248
250,250,0,0,0,0,0,0,228,0,0,0,0,0,0,0,248,248
250,250,0,0,0,0,0,0,0,0,0,0,0,0,0,0,248,248
250,250,0,0,0,95,0,0,0,0,0,253,0,0,0,0,248,248
250,250,0,0,0,0,0,0,0,0,0,269,0,92,92,92,248,248
250,250,0,0,0,0,172,174,0,0,0,0,0,0,93,92,248,248
250,250,0,228,0,0,188,190,0,0,0,0,0,92,92,92,248,248
250,250,0,0,0,0,204,206,0,182,183,184,0,0,0,0,248,248
250,250,0,0,0,0,0,0,0,198,199,200,169,170,170,171,248,248
250,250,0,0,0,0,0,0,253,0,0,0,185,0,0,187,248,248
250,250,0,0,228,0,0,0,269,0,245,0,217,0,0,187,248,248
250,250,0,0,0,0,153,0,0,0,0,0,0,0,202,203,248,248
250,251,233,233,233,233,233,233,233,233,233,233,233,233,233,233,252,248
251,233,233,233,233,233,233,233,233,233,233,233,233,233,233,233,233,252
0,0,0,0,0,0,0,0,0,0,0,0,0,0,0,0,0,0
0,0,0,0,0,0,0,0,0,0,0,0,0,0,0,0,0,0
0,0,0,0,0,0,0,0,0,0,0,0,0,0,0,0,0,0
0,0,0,0,0,0,0,0,0,0,0,0,96,0,0,0,0,0
0,0,0,0,0,0,0,0,0,0,96,0,0,0,0,0,0,0
0,0,0,0,0,0,0,0,0,0,0,0,0,0,0,0,0,0
0,0,0,0,0,0,0,0,0,0,0,0,0,0,0,0,0,0
0,0,0,0,0,0,0,0,0,0,0,0,0,0,0,0,0,0
0,0,0,0,0,0,0,0,0,0,0,0,0,0,0,0,0,0
0,0,0,0,0,0,0,0,0,0,0,0,0,0,0,0,0,0
0,0,0,0,0,0,0,0,0,0,0,0,0,0,0,0,0,0
0,0,0,0,0,0,0,0,0,0,0,0,0,0,80,0,0,0
0,0,0,0,0,80,0,0,0,0,0,0,0,0,0,0,0,0
0,0,0,0,0,0,0,0,42,0,0,0,0,0,0,0,0,0
0,0,0,0,0,0,0,0,0,0,0,0,0,0,0,0,0,0
0,0,0,0,0,0,0,0,0,0,0,0,0,0,0,0,0,0
