15
13
3
3
249,249,249,249,249,249,249,249,249,249,249,249,249,249,249
249,249,249,249,249,249,249,249,249,249,249,249,249,249,249
249,249,249,249,249,249,249,249,249,249,249,249,249,249,249
249,249,249,249,249,249,249,249,249,249,249,249,249,249,249
249,249,249,249,249,249,249,249,249,249,249,249,249,249,249
249,249,249,249,249,249,249,249,249,249,249,249,249,249,249
249,249,249,249,249,249,249,249,249,249,249,249,249,249,249
249,249,249,249,249,249,249,249,249,249,249,249,249,249,249
249,249,249,249,249,249,249,249,249,249,249,249,249,249,249
249,249,249,249,249,249,249,249,249,249,249,249,249,249,249
249,249,249,249,249,249,249,249,249,249,249,249,249,249,249
249,249,249,249,249,249,249,249,249,249,249,249,249,249,249
249,249,249,249,249,249,249,249,249,249,249,249,249,249,249
232,233,233,233,233,233,233,233,233,233,233,233,233,233,234
248,0,229,0,0,0,0,0,0,88,89,0,0,0,250
248,0,0,0,0,0,0,0,0,0,0,0,228,0,250
248,0,0,95,0,0,0,0,0,0,0,0,0,0,250
248,0,0,0,0,0,0,0,0,0,0,0,0,0,250
248,0,0,0,0,245,0,0,0,0,0,0,0,0,250
248,0,93,0,0,0,0,0,0,0,0,0,0,71,250
248,0,0,0,0,172,174,0,0,0,0,229,0,0,250
248,0,0,254,0,204,206,0,229,0,0,0,87,0,250
248,0,0,270,0,0,0,0,182,183,184,0,0,0,250
248,0,0,0,0,0,0,0,198,199,200,0,0,0,250
248,0,245,0,0,0,0,0,228,0,0,0,0,0,250
264,265,265,265,265,265,265,265,265,265,265,265,265,265,266
0,0,0,0,0,0,0,0,0,72,73,0,0,0,0
0,0,0,0,0,0,0,0,0,0,0,0,42,80,0
0,0,0,0,0,0,0,0,42,0,0,0,0,0,0
0,0,0,0,0,0,0,0,96,0,0,0,0,0,0
0,0,0,0,0,0,0,0,0,0,0,0,0,0,0
0,0,0,0,0,0,0,0,0,96,0,0,0,0,0
0,0,0,0,0,0,0,0,0,0,0,0,0,0,0
0,0,0,0,0,0,0,0,0,0,0,0,0,0,0
0,0,0,0,0,0,0,0,0,0,0,0,0,0,0
0,0,0,0,0,0,0,0,0,0,0,0,0,0,0
0,0,0,0,0,0,0,0,0,0,0,0,42,0,0
0,0,0,0,0,0,0,0,0,0,0,0,0,0,0
0,0,0,0,0,0,0,0,0,0,0,0,0,0,0
